00000000000000000000000000000000000000000000000000
22222200100000010000222222222222222220010001000422
22222200000000000000224222222222222220000000000222
22222200100001000000220000000000002220010001000222
22400000000000000000220000000000002220000000000222
22200000100001000000220000220001002220010001000222
22200000000000000000220000220000002220000000000222
22200000100001000000220000100001002220010001000222
22200000000000000000220000000000002220000000000000
22200000100001000000220000100001002220010001000100
22200000000000000000222200000002222220000000000000
22200000000000000001000000100000000000000000000422
22200010000001000000000000010000000000100010000222
22200000000000000001000000100000000000000000000222
22200010000001000000000000000000004222222000000222
00000000000000000001000000100000002222222000000222
22400010000000000000000000000000002222222000000222
22200000000000000001000000100000002222222000000222
22200010000000224000000000000000002222224000000422
00000000000000222001000000100000000000000000000222
00000000000000222000000000000000001000000001000222
00000000000000000001000000100000000000000000000222
00000022222222222222222222222222401000000001000222
00000000000000000001000000100000000000000000000000
22400001000001000000000000000000001000000001000000
22200000000000000001000000100000000000000000000000
22200000000000000000000000000000000222001000100422
22200001000001000001000000100000000222000000000222
22200000000042222200000000422200100222000000000222
22200000000022222200000000222200000222001000100222
22200001000001000000000000000000000222000000000222
22200000000000000001000000100000100222000000000222
22200000000000000000000000000000000222001000100222
22200001000001000001000000100000100222000000000222
22222222222222222222222200000000000422001000100222
22222222222222222222222200000222000000000001000222
22222222222222222222242200000222000000000000000222
00000000000000000000002200000222000100000001000000
00100000010000001000002200000222000000000000000000
00000000000000000000002200000222000002222001000100
00100010222000000000002200000222000102222000000000
00000000222000100001002200000422000002222001000100
00000000222000000000002200000000000000000000000000
00100010222000100001000000000100000100001000100010
00000000000000000000000000000000000000000000000000
22222222222222222222222200000222222222220000022222
22222222222222222222222200000224010000100000022222
00000000000000000000000000000222000000000010000022
00010000010000010000010000010222010000100000000022
00000000000000000000000000000222222222222222222222
